To be : Быть
To do : Делать
To feel : Чувствовать
To see : Видеть
To hear : Слышать
To run : Бежать
To get : Получать
To make : Сделать
To cook : Готовить
To sing : Петь
To speak : Разговаривать
To say : Говорить
To tell : Рассказывать
To take : Брать
To sit : Садиться
To stand : Стоять
To smile : Улыбаться
To open : Открывать
To close : Закрывать
To love : Любить
To like : Нравиться
To give : Давать
To bring : Приносить
To breath : Дышать
To buy : Покупать
To forget : Забывать
To believe : Верить
To have : Иметь
To go : Идти
To know : Знать
To think : Думать
To come : Приходить
To want : Хотеть
To use : Использовать
To find : Находить
To work : Работать
To eat : Есть
To write : Писать
To read : Читать
To call : Звонить
To try : Пытаться
To need : Нуждаться
To become : Становиться
To put : Класть
To leave : Оставлять
To pay : Платить
To pray : Молиться
To stay : Оставаться
To mean : Означать
To keep : Держать, хранить
To let : Оставлять
To begin : Начинать
To start : Стартовать
To finish : Заканчивать
To show : Показывать
To cry : Плакать
To move : Двигаться
To jump : Прыгать
To live : Жить
To die : Умирать
To happen : Случаться
To lose : Проигрывать
To hate : Ненавидеть
To include : Включать в себя
To turn on : Включать (о приборе)
To turn off : Выключать
To change : Менять
To wash : Мыть
To clean : Убирать, очищать
To lead : Вести
To understand : Понимать
To watch : Смотреть
To discover : Исследовать
To imagine : Представлять
To introduce : Представить
To follow : Следовать
To create : Создавать
To grow : Расти
To spend : Тратить
To win : Выигрывать
To offer : Предлагать
To learn : Изучать
To appear : Появляться
To disappear : Исчезать
To build : Строить
To break : Ломать
To send : Посылать
To fall : Падать
To cut : Резать
To achieve : Достигать
To kill : Убивать
To pass : Проходить
To fly : Летать
To swim : Плавать
To decide : Решать
To return : Возвращаться
To hope : Надеяться
To explain : Объяснять
To propose : Предлагать
To develop : Развивать
To support : Поддерживать
To dance : Танцевать
To draw : Рисовать
To book : Бронировать
To be afraid : Бояться
To agree : Соглашаться
To check up : Проверять
To delete : Удалять
To choose : Выбирать
To catch : Ловить
To ask : Спрашивать
To answer : Отвечать
To hesitate : Cомневаться
air : Воздух
wind : Ветер
water : Вода
east : Восток
north : Север
south : Юг
tree : Дерево
sea : Море
plant : Растение
flower : Цветок
forest : Лес
person : Личность
night : Ночь
morning : Утро
day : День
evening : Вечер
life : Жизнь
mountain : Гора
land : Земля
house : Дом
fire : Огонь
country : Страна
animal : Животное
bird : Птица
fish : Рыба
insect : Насекомое
city : Город
world : Мир
boy : Мальчик
girl : Девочка
mother : Мама
father : Отец
son : Сын
daughter : Дочь
baby : Малыш
family : Семья
grand mother : Бабушка
grand father : Дедушка
children : Дети
home : Дом
love : Любовь
joy : Радость
nephew : Племянник
aunt : Тетя
uncle : Дядя
cousin : Двоюродная сестра или брат
man : Мужчина
woman : Женщина
child : Ребенок
sister : Сестра
brother : Брат
Relatives : Родственники
friend : Друг
wife : Жена
husband : Муж
address : Адрес
happiness : Счастье
People : Люди
phone : Телефон
question : Вопрос
place : Место
market : Рынок
order : Заказ
food : Еда
work : Работа
communication : Общение
story : История
relax : Отдых
time : Время
word : Слово
meeting : Встреча
week : Неделя
distance : Дистанция
club : Клуб
theatre : Театр
cinema : Кинотеатр
coffee shop : Кофейня
friendship : Дружба
behavior : Поведение
attitude : Отношение
student : Студент
university : Университет
union : Объединение
party : Вечеринка
date : Свидание
leisure time : Досуг
road : Дорога
ticket : Билет
map : Карта
highway : Шоссе
reception : Регистратура, ресепшн
wallet : Бумажник
bank : Банк
subway : Метро
cab : Такси
parking : Парковка
cash : Наличные
passport : Паспорт
permission : Разрешение
lawyer : Адвокат
problem : Проблема
waiting room : Зал ожидания
transfer : Пересадка
bag : Сумка
suitcase : Чемодан
property : Имущество
law : Право, закон
police station : Полицейский участок
price : Стоимость, цена
price list : Ценник
courier : Курьер
delivery : Доставка
location : Местоположение
route : Маршрут
agreement : Договор
hospital : Больница
ambulance : Скорая помощь
Afraid : Напуганный
Angry : Сердитый
Asleep : Спящий
Attentive : Внимательный
Basic : Базовый
Beautiful : Красивый
Brave : Смелый
Busy : Занятой
Calm : Спокойный
Careful : Внимательный, заботливый
Cheap : Дешевый
Clean : Чистый
Clever : Умный
Cold : Холодный
Comfortable : Комфортный
Confident : Уверенный
Constant : Постоянный
Curious : Любопытный
Dangerous : Опасный
Dark : Темный
Deep : Глубокий
Different : Разный
Difficult : Трудный
Dirty : Грязный
Easy : Легкий
Every : Каждый
Expensive : Дорогой
Exact : Точный
Fast : Быстрый
Fair : Честный, светлый
Fine : Замечательный
Foreign : Иностранный
Free : Свободный
Fresh : Свежий
Full : Полный
Funny : Забавный
Guilty : Виновный
Healthy : Здоровый
Hard : Тяжелый
Helpful : Полезный
Honest : Честный
Hot : Горячий
Hungry : Голодный
Important : Важный
Illegal : Нелегальный, незаконный
Impossible : Невозможный
Independent : Независимый
Interesting : Интересный
Kind : Добрый
Legal : Законный
Little : Маленький
Lucky : Удачливый
Necessary : Необходимый
Normal : Нормальный
Old : Старый
Opposite : Противоположный
Perfect : Идеальный
Poor : Бедный
Powerful : Мощный
Possible : Возможный
Quiet : Тихий
Rare : Редкий
Recent : Недавний
Relevant : Релевантный, актуальный
Remote : Удаленный
Safe : Безопасный
Short : Короткий
Small : Маленький
Strange : Странный, незнакомый, чужой
Successful : Успешный
Tasty : Вкусный, приятный
Terrible : Жуткий
Tired : Усталый
Warm : Теплый
Weak : Слабый
Sad : Грустный
International : Международный
According : В соответствии
Again : Снова
Always : Всегда
Beautifully : Красиво
Carefully : Осторожно
Correctly : Верно, правильно
Especially : Особенно
Friendly : Дружелюбно
Indeed : Действительно
Above : Выше
Accidentally : Случайно
Actually : На самом деле
Badly : Плохо
Besides : Помимо этого
Briefly : Кратко
Certainly : Конечно
Daily : Ежедневно
Dreamily : Мечтательно
Even : Даже
Foolishly : Глупо
Forward : Вперед
Ever : Когда-либо
Equally : Одинаково
Fortunately : К счастью
Instead : Вместо
Inside : Внутри
Hardly : С трудом
Lately : Недавно
Less : Меньше
Loudly : Громко, шумно
Nearly : Около
Never : Никогда
Only : Только
Once : Один раз
Often : Часто
Perhaps : Возможно
Quickly : Быстро
Probably : Вероятно
Rarely : Редко
Really : Действительно
Sometimes : Иногда
Yesterday : Вчера
Thus : Таким образом
Somehow : Как-то
Soon : Скоро
Regularly : Регулярно
Somewhere : Где-то